111111111111111111111
11111100000C000000001
101111000011100000001
100000000000000000001
1000P0000000000001111
100000000000000C00001
111111110000000000001
1000C000000000000C001
100000111011111000001
1000000C1100000000001
100000001000E00000001
111111111111111111111
