1111111111111
100P000001
10000000E1
1000000000001
1111111111111