11111
1P0C1
10001
100E1
11111
